....#...............#....
....#.........^.....#....
...##...............#....
..##...####.........#....
..#...##..##........#....
..#..####..##.......#....
..#.....##..#.......#....
..##.....#...#......#....
..##.....##..##.....#....
...#......#..#......#....
...#.^...##.##...^..#....
........##..#......#.....
..#.....#...#......#.....
..#.....#....#.....#.....
..#.....#....#.....##....
..#.....#....#......#....
..#.....#....#......##...
..#.....#....#.......#...
..#....####...#......#...
..##......#...#.....#....
...#......#..##..........
...##.^...####..^...#....
....#..............#.....
...........#.............
..........####...........